<greska>		 greska
<papir>     papir
<sil>			 sil 
<udarac>		 udarac
<uzdah>			 uzdah
SENT-END			sil
SENT-START			sil
^e			Cc e
`aliti			Z a l i t i
a			a
ako			a k o
alergije			a l e r g i j e
alergi~ne			a l e r g i C n e
ali			a l i
alpa			a l p a
ankica			a n k i c a
ankice			a n k i c e
anticiklona			a n t i c i k l o n a
anticiklonalni			a n t i c i k l o n a l n i
anticiklonalno			a n t i c i k l o n a l n o
anticiklonalnog			a n t i c i k l o n a l n o g
anticiklone			a n t i c i k l o n e
astmati~ara			a s t m a t i C a r a
astmati~are			a s t m a t i C a r e
astmati~ari			a s t m a t i C a r i
astmati~arima			a s t m a t i C a r i m a
atlantska			a t l a n t s k a
atmosferski			a t m o s f e r s k i
atmosferskog			a t m o s f e r s k o g
b			b
badnju			b a d N u
bar			b a r
baranji			b a r a N i
barem			b a r e m
bazge			b a z g e
bez			b e z
bi			b i
bila			b i l a
biokova			b i o k o v a
biokovu			b i o k o v u
biometeorolo{ka			b i o m e t e o r o l o S k a
biometeorolo{ke			b i o m e t e o r o l o S k e
biometeorolo{ki			b i o m e t e o r o l o S k i
biometeorolo{kih			b i o m e t e o r o l o S k i h
biometeorolo{kog			b i o m e t e o r o l o S k o g
bismo			b i s m o
bit			b i t
biti			b i t i
blagdan			b l a g d a n
blizini			b l i z i n i
blizinu			b l i z i n u
blizu			b l i z u
bo`i^			b o Z i Cc
bolesnici			b o l e s n i c i
bolesnicima			b o l e s n i c i m a
bolesnika			b o l e s n i k a
bolesnike			b o l e s n i k e
bolestima			b o l e s t i m a
bolje			b o L e
bolji			b o L i
bolova			b o l o v a
bolove			b o l o v e
bolovi			b o l o v i
bolovima			b o l o v i m a
boravak			b o r a v a k
borivoj			b o r i v o j
botovo			b o t o v o
breze			b r e z e
brod			b r o d
brzo			b r z o
brzoj			b r z o j
bude			b u d e
budimpe{ta			b u d i m p e S t a
budimpe{te			b u d i m p e S t e
bura			b u r a
bure			b u r e
burin			b u r i n
burom			b u r o m
buru			b u r u
c			c
cc			Cc
celzijev			c e l z i j e v
centimetara			c e n t i m e t a r a
centra			c e n t r a
cesti			c e s t i
cijeloj			c i j e l o j
cijelom			c i j e l o m
cijelu			c i j e l u
ciklona			c i k l o n a
ciklonalno			c i k l o n a l n o
ciklonalnog			c i k l o n a l n o g
ciklone			c i k l o n e
cjelodnevne			c j e l o d n e v n e
cjelodnevnom			c j e l o d n e v n o m
crnac			c r n a c
d			d
da			d a
dalje			d a L e
dalmacije			d a l m a c i j e
dalmaciji			d a l m a c i j i
dalmaciju			d a l m a c i j u
dalmatinskome			d a l m a t i n s k o m e
dan			d a n
dana			d a n a
danas			d a n a s
dana{njega			d a n a S N e g a
dana{nji			d a n a S N i
dane			d a n e
danju			d a N u
davor			d a v o r
de`urna			d e Z u r n a
depresijsko			d e p r e s i j s k o
deset			d e s e t
desetak			d e s e t a k
devedeset			d e v e d e s e t
devedesetidevet			d e v e d e s e t i d e v e t
devedesetisedam			d e v e d e s e t i s e d a m
devet			d e v e t
devetnaest			d e v e t n a e s t
devetoga			d e v e t o g a
dijela			d i j e l a
dijelom			d i j e l o m
dijelovima			d i j e l o v i m a
dijelu			d i j e l u
diljem			d i L e m
dio			d i o
divljeg			d i v L e g
divlji			d i v L i
djelomice			d j e l o m i c e
djelomi~no			d j e l o m i C n o
djelovati			d j e l o v a t i
dnevna			d n e v n a
dnevne			d n e v n e
do			d o
doba			d o b a
dobar			d o b a r
dobili			d o b i l i
dobre			d o b r e
dobro			d o b r o
dobrog			d o b r o g
dobroga			d o b r o g a
dobrom			d o b r o m
dobru			d o b r u
dodatne			d o d a t n e
dodiru			d o d i r u
dok			d o k
dokazanom			d o k a z a n o m
dolina			d o l i n a
dolinu			d o l i n u
donijeti			d o n i j e t i
donji			d o N i
donositi			d o n o s i t i
dosta			d o s t a
dr`avnog			d r Z a v n o g
dr`avnoga			d r Z a v n o g a
dragojlovi^			d r a g o j l o v i Cc
dragoslav			d r a g o s l a v
drava			d r a v a
drugdje			d r u g d j e
drugom			d r u g o m
drugome			d r u g o m e
drvar			d r v a r
drve^a			d r v e Cc a
du`			d u Z
du`a			d u Z a
du`e			d u Z e
du`im			d u Z i m
du`obale			d u Z o b a l e
duboka			d u b o k a
dubrova~kom			d u b r o v a C k o m
dubrova~kome			d u b r o v a C k o m e
dugotrajna			d u g o t r a j n a
dugotrajno			d u g o t r a j n o
dugotrajnom			d u g o t r a j n o m
dugotrajnu			d u g o t r a j n u
dulja			d u L a
dulje			d u L e
duljih			d u L i h
dunav			d u n a v
dunja			d u N a
dva			d v a
dvadeset			d v a d e s e t
dvadeseti			d v a d e s e t i
dvadesetidva			d v a d e s e t i d v a
dvadesetijedan			d v a d e s e t i j e d a n
dvadesetipet			d v a d e s e t i p e t
dvadesetitri			d v a d e s e t i t r i
dvadeseti{est			d v a d e s e t i S e s t
dvadeseti~etiri			d v a d e s e t i C e t i r i
dvadesetoj			d v a d e s e t o j
dvanaest			d v a n a e s t
dvije			d v i j e
dvjesto			d v j e s t o
dvjestodevet			d v j e s t o d e v e t
dvjestodva			d v j e s t o d v a
dvjestodvadeseti~etiri			d v j e s t o d v a d e s e t i C e t i r i
dvjestoosam			d v j e s t o o s a m
dvjestoosamdesetidevet			d v j e s t o o s a m d e s e t i d e v e t
dvjestopedesetiosam			d v j e s t o p e d e s e t i o s a m
dvjestosedamdesetitri			d v j e s t o s e d a m d e s e t i t r i
dvjestotridesetitri			d v j e s t o t r i d e s e t i t r i
dvjesto{ezdeset			d v j e s t o S e z d e s e t
dvjesto~etrdeset			d v j e s t o C e t r d e s e t
dvjesto~etrdesetipet			d v j e s t o C e t r d e s e t i p e t
dvjesto~etrdeseti{est			d v j e s t o C e t r d e s e t i S e s t
dvjesto~etrdeseti~etiri			d v j e s t o C e t r d e s e t i C e t i r i
dvjesto~etrnaest			d v j e s t o C e t r n a e s t
dz		 dz
e			e
egejskim			e g e j s k i m
egejskome			e g e j s k o m e
europe			e u r o p e
europom			e u r o p o m
europska			e u r o p s k a
europske			e u r o p s k e
europskim			e u r o p s k i m
europskog			e u r o p s k o g
europskoga			e u r o p s k o g a
f			f
formira			f o r m i r a
formiranje			f o r m i r a N e
fronta			f r o n t a
frontalni			f r o n t a l n i
frontalnim			f r o n t a l n i m
fronte			f r o n t e
frontom			f r o n t o m
g			g
gdje			g d j e
glasi			g l a s i
glavninom			g l a v n i n o m
glavobolja			g l a v o b o L a
glavobolje			g l a v o b o L e
glavobolju			g l a v o b o L u
godine			g o d i n e
godinu			g o d i n u
gorju			g o r j u
gorski			g o r s k i
gorskim			g o r s k i m
gorskog			g o r s k o g
gorskoj			g o r s k o j
gorskom			g o r s k o m
gorskome			g o r s k o m e
gotovo			g o t o v o
govori			g o v o r i
granici			g r a n i c i
greben			g r e b e n
grebena			g r e b e n a
greska			g r e s k a
grmljavina			g r m L a v i n a
grmljavine			g r m L a v i n e
grmljavinom			g r m L a v i n o m
grmljavinu			g r m L a v i n u
h			h
hidrometeorolo{kog			h i d r o m e t e o r o l o S k o g
hidrometeorolo{koga			h i d r o m e t e o r o l o S k o g a
hladna			h l a d n a
hladne			h l a d n e
hladnije			h l a d n i j e
hladno			h l a d n o
hladno^a			h l a d n o Cc a
hladno^e			h l a d n o Cc e
hladno^u			h l a d n o Cc u
hladnog			h l a d n o g
hladnoga			h l a d n o g a
hladnom			h l a d n o m
hrast			h r a s t
hrasta			h r a s t a
hrvatska			h r v a t s k a
hrvatske			h r v a t s k e
hrvatskoj			h r v a t s k o j
hrvatskom			h r v a t s k o m
hrvatskome			h r v a t s k o m e
hrvatsku			h r v a t s k u
i			i
iako			i a k o
ih			i h
ili			i l i
ilok			i l o k
ima			i m a
imaju			i m a j u
imat			i m a t
imati			i m a t i
inverzija			i n v e r z i j a
ipak			i p a k
iskoristite			i s k o r i s t i t e
ispod			i s p o d
ista			i s t a
iste			i s t e
istok			i s t o k
istoku			i s t o k u
isto~ni			i s t o C n i
isto~nim			i s t o C n i m
isto~njak			i s t o C N a k
isto~njaka			i s t o C N a k a
isto~njakom			i s t o C N a k o m
isto~noeuropske			i s t o C n o e u r o p s k e
isto~nog			i s t o C n o g
isto~noj			i s t o C n o j
isto~nom			i s t o C n o m
istre			i s t r e
istri			i s t r i
italije			i t a l i j e
italiji			i t a l i j i
italijom			i t a l i j o m
iz			i z
izbjegavaju			i z b j e g a v a j u
izbjegavanje			i z b j e g a v a N e
izbjegavati			i z b j e g a v a t i
izdi^i			i z d i Cc i
izgledi			i z g l e d i
izgledima			i z g l e d i m a
izjedna~enog			i z j e d n a C e n o g
izme}u			i z m e dz u
izmjerenih			i z m j e r e n i h
izmjereno			i z m j e r e n o
iznad			i z n a d
iznadprosje~no			i z n a d p r o s j e C n o
iznimno			i z n i m n o
izra`en			i z r a Z e n
izra`ene			i z r a Z e n e
izuzetno			i z u z e t n o
izvje{^e			i z v j e S Cc e
izvje{taj			i z v j e S t a j
j			j
jadran			j a d r a n
jadrana			j a d r a n a
jadranom			j a d r a n o m
jadranu			j a d r a n u
jak			j a k
jaka			j a k a
jaki			j a k i
jakim			j a k i m
jako			j a k o
jakom			j a k o m
jaku			j a k u
jasenovac			j a s e n o v a c
javno			j a v n o
ja~a			j a C a
ja~anje			j a C a N e
ja~anju			j a C a N u
ja~ati			j a C a t i
ja~e			j a C e
ja~i			j a C i
ja~u			j a C u
je			j e
jedan			j e d a n
jedanaeset			j e d a n a e s e t
jedanaest			j e d a n a e s t
jedino			j e d i n o
jedna			j e d n a
jednog			j e d n o g
jednoga			j e d n o g a
jonskim			j o n s k i m
jonsko			j o n s k o
jonskog			j o n s k o g
jonskom			j o n s k o m
jonskome			j o n s k o m e
jo{			j o S
ju`ne			j u Z n e
ju`ni			j u Z n i
ju`nim			j u Z n i m
ju`no			j u Z n o
ju`nog			j u Z n o g
ju`noga			j u Z n o g a
ju`noj			j u Z n o j
ju`nom			j u Z n o m
ju`nome			j u Z n o m e
jug			j u g
juga			j u g a
jugo			j u g o
jugoistok			j u g o i s t o k
jugoistoka			j u g o i s t o k a
jugoisto~ni			j u g o i s t o C n i
jugoisto~njak			j u g o i s t o C N a k
jugom			j u g o m
jugozapada			j u g o z a p a d a
jugozapadak			 j u g o z a p a d a k 
jugozapadni			j u g o z a p a d n i
jugozapadnjak			j u g o z a p a d N a k
jugozapadnog			j u g o z a p a d n o g
jugu			j u g u
juri			j u r i
jutarnja			j u t a r N a
jutarnje			j u t a r N e
jutarnjih			j u t a r N i h
jutarnju			j u t a r N u
jutra			j u t r a
jutro			j u t r o
jutros			j u t r o s
k			 k 
k			k
kada			k a d a
kakvo			k a k v o
kalin			k a l i n
kanalu			k a n a l u
kao			k a o
karlovac			k a r l o v a c
karlova~koj			k a r l o v a C k o j
karlovcu			k a r l o v c u
kasno			k a s n o
kesten			k e s t e n
kestena			k e s t e n a
kidanja			k i d a N a
kidanje			k i d a N e
kilometara			k i l o m e t a r a
kilometra			k i l o m e t r a
ki{a			k i S a
ki{e			k i S e
ki{om			k i S o m
ki{ovito			k i S o v i t o
ki{u			k i S u
klini~ki			k l i n i C k i
kod			k o d
koja			k o j a
koje			k o j e
kojeg			k o j e g
kojega			k o j e g a
koji			k o j i
kojim			k o j i m
kojoj			k o j o j
koli~ina			k o l i C i n a
koncentracija			k o n c e n t r a c i j a
koncentracije			k o n c e n t r a c i j e
koncentraciji			k o n c e n t r a c i j i
koncentracijom			k o n c e n t r a c i j o m
koncentraciju			k o n c e n t r a c i j u
kopna			k o p n a
kopnenim			k o p n e n i m
kopnenom			k o p n e n o m
kopnenome			k o p n e n o m e
kopnom			k o p n o m
kornata			k o r n a t a
kornati			k o r n a t i
korova			k o r o v a
kostajnica			k o s t a j n i c a
kotar			k o t a r
kotara			k o t a r a
kotaru			k o t a r u
kotlinama			k o t l i n a m a
kra^a			k r a Cc a
kra^ih			k r a Cc i h
kra^im			k r a Cc i m
kraja			k r a j a
krajem			k r a j e m
krajeva			k r a j e v a
krajevima			k r a j e v i m a
krajnjeg			k r a j N e g
krajnjem			k r a j N e m
kraju			k r a j u
kratka			k r a t k a
kratki			k r a t k i
kratkotrajan			k r a t k o t r a j a n
kratkotrajna			k r a t k o t r a j n a
kratkotrajne			k r a t k o t r a j n e
kratkotrajni			k r a t k o t r a j n i
kratkotrajnih			k r a t k o t r a j n i h
kratkotrajnim			k r a t k o t r a j n i m
kratkotrajno			k r a t k o t r a j n o
kratkotrajnog			k r a t k o t r a j n o g
kratkotrajnom			k r a t k o t r a j n o m
kratkotrajnu			k r a t k o t r a j n u
kre^e			k r e Cc e
kre^u			k r e Cc u
kred			 k r e d 
kroni~ne			k r o n i C n e
kroni~ni			k r o n i C n i
kroni~nih			k r o n i C n i h
kroni~nim			k r o n i C n i m
kroz			k r o z
kru`i			k r u Z i
krvo`ilnim			k r v o Z i l n i m
kupa			k u p a
kvarneru			k v a r n e r u
l			l
lak{e			l a k S e
lebi^			l e b i Cc
ledi			l e d i
lediti			l e d i t i
levant			l e v a n t
levanta			l e v a n t a
lici			l i c i
ligurskim			l i g u r s k i m
ligurskog			l i g u r s k o g
ligurskoga			l i g u r s k o g a
ligurskom			l i g u r s k o m
ligurskome			l i g u r s k o m e
lijepo			l i j e p o
like			l i k e
liku			l i k u
lipnja			l i p N a
ljude			L u d e
ljudi			L u d i
ljudima			L u d i m a
lokalne			l o k a l n e
lokalni			l o k a l n i
lokalnih			l o k a l n i h
lokalnim			l o k a l n i m
lovro			l o v r o
lo{a			l o S a
lo{e			l o S e
lo{ije			l o S i j e
lo{ijeg			l o S i j e g
lo{iju			l o S i j u
m			m
maestral			m a e s t r a l
magla			m a g l a
magle			m a g l e
magli			m a g l i
maglom			m a g l o m
maglovita			m a g l o v i t a
maglovito			m a g l o v i t o
maglovitog			m a g l o v i t o g
maglu			m a g l u
mahovi^			m a h o v i Cc
mahovli^			m a h o v l i Cc
makarskog			m a k a r s k o g
makarskoj			m a k a r s k o j
mala			m a l a
malo			m a l o
malom			m a l o m
malu			m a l u
manja			m a N a
manje			m a N e
manjom			m a N o m
manju			m a N u
marija			m a r i j a
meteorolo{ke			m e t e o r o l o S k e
meteorolo{kog			m e t e o r o l o S k o g
meteorolo{koga			m e t e o r o l o S k o g a
meteoropata			m e t e o r o p a t a
meteoropate			m e t e o r o p a t e
meteoropati			m e t e o r o p a t i
metkovi^			m e t k o v i Cc
me}imurju			m e dz i m u r j u
miholjac			m i h o L a c
mijenja			m i j e N a
mijenjati			m i j e N a t i
minimalna			m i n i m a l n a
minus			m i n u s
minuti			m i n u t i
mirna			m i r n a
mirno			m i r n o
mirnog			m i r n o g
mirnoga			m i r n o g a
mjesta			m j e s t a
mjestima			m j e s t i m a
mjestimice			m j e s t i m i c e
mjestimi~na			m j e s t i m i C n a
mjestimi~ni			m j e s t i m i C n i
mjestimi~nim			m j e s t i m i C n i m
mjestimi~nom			m j e s t i m i C n o m
mjestimi~nu			m j e s t i m i C n u
mnogi			m n o g i
mo`e			m o Z e
mogla			m o g l a
mogle			m o g l e
mogli			m o g l i
moglo			m o g l o
mogu			m o g u
mogu^			m o g u Cc
mogu^a			m o g u Cc a
mogu^e			m o g u Cc e
mogu^i			m o g u Cc i
mogu^nost			m o g u Cc n o s t
mogu^no{^u			m o g u Cc n o S Cc u
mohori^			m o h o r i Cc
mokori^			m o k o r i Cc
mora			m o r a
moramo			m o r a m o
more			m o r e
morem			m o r e m
moru			m o r u
mraz			m r a z
mu			m u
mu~iti			m u C i t i
n			n
na			n a
nad			n a d
nadalje			n a d a L e
naime			n a i m e
najisto~nijim			n a j i s t o C n i j i m
najkasnije			n a j k a s n i j e
najmanje			n a j m a N e
najni`a			n a j n i Z a
najni`e			n a j n i Z e
najni`u			n a j n i Z u
najobla~nije			n a j o b l a C n i j e
najosjetljiviji			n a j o s j e t L i v i j i
najprije			n a j p r i j e
najsjevernijim			n a j s j e v e r n i j i m
najsun~anije			n a j s u n C a n i j e
najve^a			n a j v e Cc a
najvi{a			n a j v i S a
najvi{e			n a j v i S e
najvi{em			n a j v i S e m
najvi{om			n a j v i S o m
najvi{u			n a j v i S u
najzapadnijim			n a j z a p a d n i j i m
nakon			n a k o n
nam			n a m
naoblaka			n a o b l a k a
naoblake			n a o b l a k e
naoblakom			n a o b l a k o m
naoblaku			n a o b l a k u
naobla~enje			n a o b l a C e N e
naobla~it			n a o b l a C i t
naobla~iti			n a o b l a C i t i
napora			n a p o r a
napore			n a p o r e
nas			n a s
nastavku			n a s t a v k u
nastavlja			n a s t a v L a
nata{a			n a t a S a
nave~er			n a v e C e r
na{e			n a S e
na{ih			n a S i h
ne			n e
ne^e			n e Cc e
nedjelje			n e d j e L e
nedjelju			n e d j e L u
nego			n e g o
neka			n e k a
neki			n e k i
nekim			n e k i m
nekoliko			n e k o l i k o
nema			n e m a
nepogodne			n e p o g o d n e
nepogodni			n e p o g o d n i
nepogodno			n e p o g o d n o
nepovoljan			n e p o v o L a n
nepovoljna			n e p o v o L n a
nepovoljne			n e p o v o L n e
nepovoljni			n e p o v o L n i
nepovoljnih			n e p o v o L n i h
nepovoljniji			n e p o v o L n i j i
nepovoljnijih			n e p o v o L n i j i h
nepovoljno			n e p o v o L n o
nepovoljnog			n e p o v o L n o g
neretva			n e r e t v a
nervozu			n e r v o z u
nesanica			n e s a n i c a
nesanice			n e s a n i c e
nesre^e			n e s r e Cc e
nestabilan			n e s t a b i l a n
nestabilna			n e s t a b i l n a
nestabilni			n e s t a b i l n i
nestabilno			n e s t a b i l n o
nestabilnog			n e s t a b i l n o g
nestabilnosti			n e s t a b i l n o s t i
nevere			n e v e r e
neverin			n e v e r i n
neverina			n e v e r i n a
neverini			n e v e r i n i
nevrijeme			n e v r i j e m e
neznatne			n e z n a t n e
neznatno			n e z n a t n o
ne{to			n e S t o
ni			n i
ni`a			n i Z a
ni`e			n i Z e
ni`im			n i Z i m
niska			n i s k a
niske			n i s k e
niski			n i s k i
niskih			n i s k i h
niskim			n i s k i m
nismo			n i s m o
nizinam			n i z i n a m
nizinama			n i z i n a m a
ni{tice			n i S t i c e
ni{ticu			n i S t i c u
njegov			N e g o v
njegovom			N e g o v o m
njegovu			N e g o v u
no			n o
no^			n o Cc
no^as			n o Cc a s
no^i			n o Cc i
no^na			n o Cc n a
no^u			n o Cc u
nova			n o v a
novo			n o v o
novogodi{njoj			n o v o g o d i S N o j
no{en			n o S e n
nula			n u l a
nule			n u l e
o			o
o`ujka			o Z u j k a
obale			o b a l e
obali			o b a l i
obalnom			o b a l n o m
obalu			o b a l u
obilnije			o b i l n i j e
obilnijim			o b i l n i j i m
oblaci			o b l a c i
oblacima			o b l a c i m a
oblaka			o b l a k a
oblake			o b l a k e
obla~ni			o b l a C n i
obla~nije			o b l a C n i j e
obla~no			o b l a C n o
oborina			o b o r i n a
oborinama			o b o r i n a m a
oborine			o b o r i n e
oborinom			o b o r i n o m
obrnuto			o b r n u t o
od			o d
odakle			o d a k l e
odgovaraju^a			o d g o v a r a j u Cc a
odgovaraju^e			o d g o v a r a j u Cc e
odgovaraju^u			o d g o v a r a j u Cc u
odje^a			o d j e Cc a
odjenuti			o d j e n u t i
odmicanja			o d m i c a N a
odmi~e			o d m i C e
odnosu			o d n o s u
oja~alo			o j a C a l o
oja~ao			o j a C a o
oja~ati			o j a C a t i
oja~ava			o j a C a v a
oko			o k o
okrenut			o k r e n u t
okrenuti			o k r e n u t i
okretanju			o k r e t a N u
okretati			o k r e t a t i
olujan			o l u j a n
olujna			o l u j n a
olujne			o l u j n e
olujnim			o l u j n i m
olujno			o l u j n o
olujnom			o l u j n o m
olujnu			o l u j n u
one			o n e
oni			o n i
op^eg			o p Cc e g
oprostite			o p r o s t i t e
oraha			o r a h a
orkanska			o r k a n s k a
orkanskim			o r k a n s k i m
osam			o s a m
osamdeset			o s a m d e s e t
osamdesetijedan			o s a m d e s e t i j e d a n
osamdesetisedam			o s a m d e s e t i s e d a m
osamnaest			o s a m n a e s t
osijek			o s i j e k
osijeku			o s i j e k u
osje^at			o s j e Cc a t
osje^ati			o s j e Cc a t i
osjetiti			o s j e t i t i
osjetljive			o s j e t L i v e
osjetljivi			o s j e t L i v i
osjetljivih			o s j e t L i v i h
osjetljivije			o s j e t L i v i j e
osjetljiviji			o s j e t L i v i j i
osjetljivijim			o s j e t L i v i j i m
osjetljivima			o s j e t L i v i m a
osjetljivosti			o s j e t L i v o s t i
osjetno			o s j e t n o
oslabio			o s l a b i o
oslabit			o s l a b i t
oslabiti			o s l a b i t i
oslabjet			o s l a b j e t
oslabjeti			o s l a b j e t i
oslabljen			o s l a b L e n
oslabljena			o s l a b L e n a
oslabljene			o s l a b L e n e
oslabljeni			o s l a b L e n i
oslabljenim			o s l a b L e n i m
oslabljenom			o s l a b L e n o m
osmanaest			o s m a n a e s t
osmi			o s m i
osobama			o s o b a m a
osobe			o s o b e
osobito			o s o b i t o
ostalim			o s t a l i m
ostalog			o s t a l o g
ostalom			o s t a l o m
osvje`enje			o s v j e Z e N e
otocima			o t o c i m a
otrantskim			o t r a n t s k i m
otvorena			o t v o r e n a
otvorenom			o t v o r e n o m
otvorenome			o t v o r e n o m e
otvorenomu			o t v o r e n o m u
ovo			o v o
ovog			o v o g
ovoga			o v o g a
ozljeda			o z L e d a
o~ekivati			o C e k i v a t i
o~ekuje			o C e k u j e
o~ekuju			o C e k u j u
p			p
pa			p a
pada			p a d a
padao			p a d a o
padati			p a d a t i
padom			p a d o m
padu			p a d u
pahulja			p a h u L a
papir			 p a p i r 
papir			p a p i r
parkova			p a r k o v a
past			p a s t
pasti			p a s t i
patiti			p a t i t i
pedeset			p e d e s e t
pedesetipet			p e d e s e t i p e t
pelud			p e l u d
peluda			p e l u d a
pet			p e t
petak			p e t a k
peti			p e t i
petka			p e t k a
petnaest			p e t n a e s t
petnaesti			p e t n a e s t i
petsto			p e t s t o
petstojedanaest			p e t s t o j e d a n a e s t
petstopedesetijedan			p e t s t o p e d e s e t i j e d a n
petstosedamdeset			p e t s t o s e d a m d e s e t
petsto~etrdesetidevet			p e t s t o C e t r d e s e t i d e v e t
pla~ko			p l a C k o
plitka			p l i t k a
plitko			p l i t k o
pljoskovi			 p L o s k o v i 
pljusak			p L u s a k
pljuska			p L u s k a
pljuskom			p L u s k o m
pljuskova			p L u s k o v a
pljuskove			p L u s k o v e
pljuskovi			p L u s k o v i
pljuskovima			p L u s k o v i m a
plu^nih			p l u Cc n i h
plus			p l u s
po			p o
pobolj{anje			p o b o L S a N e
pobolj{ati			p o b o L S a t i
pod			p o d
podataka			p o d a t a k a
podne			p o d n e
podneva			p o d n e v a
podno			p o d n o
podno{ljivija			p o d n o S L i v i j a
podr`ava			p o d r Z a v a
podr`avati			p o d r Z a v a t i
podravini			p o d r a v i n i
podru~ja			p o d r u C j a
podru~je			p o d r u C j e
podru~jima			p o d r u C j i m a
podru~ju			p o d r u C j u
podvelebitskom			p o d v e l e b i t s k o m
pogodne			p o g o d n e
pogodni			p o g o d n i
pogodnih			p o g o d n i h
pogodniji			p o g o d n i j i
pogor{anje			p o g o r S a N e
pogor{ati			p o g o r S a t i
pojasu			p o j a s u
pojaviti			p o j a v i t i
pojavljivati			p o j a v L i v a t i
poja~an			p o j a C a n
poja~ana			p o j a C a n a
poja~ane			p o j a C a n e
poja~anju			p o j a C a N u
poja~ano			p o j a C a n o
poja~anu			p o j a C a n u
poja~at			p o j a C a t
poja~ati			p o j a C a t i
pokoji			p o k o j i
pokojim			p o k o j i m
pokre^e			p o k r e Cc e
pokretna			p o k r e t n a
pokretno			p o k r e t n o
polako			p o l a k o
poledica			p o l e d i c a
poledice			p o l e d i c e
polje			p o L e
pomicati			p o m i c a t i
pomi~e			p o m i C e
pomorske			p o m o r s k e
pomorskog			p o m o r s k o g
pomorskoga			p o m o r s k o g a
ponajprije			p o n a j p r i j e
ponajvi{e			p o n a j v i S e
ponedjeljak			p o n e d j e L a k
ponedjeljka			p o n e d j e L k a
ponegdje			p o n e g d j e
poneka			p o n e k a
ponovno			p o n o v n o
ponovo			p o n o v o
popunjava			p o p u N a v a
porast			p o r a s t
porasti			p o r a s t i
poreme^aj			p o r e m e Cc a j
poreme^ajem			p o r e m e Cc a j e m
posavini			p o s a v i n i
posebice			p o s e b i c e
posebno			p o s e b n o
poslije			p o s l i j e
poslijepodne			p o s l i j e p o d n e
poslijepodneva			p o s l i j e p o d n e v a
poslijepodnevna			p o s l i j e p o d n e v n a
postojane			p o s t o j a n e
postojano			p o s t o j a n o
postoji			p o s t o j i
postupan			p o s t u p a n
postupna			p o s t u p n a
postupni			p o s t u p n i
postupno			p o s t u p n o
postupnom			p o s t u p n o m
posvuda			p o s v u d a
pote{ko^a			p o t e S k o Cc a
pote{ko^e			p o t e S k o Cc e
poticajno			p o t i c a j n o
potkraj			p o t k r a j
potom			p o t o m
potrebna			p o t r e b n a
pove^anom			p o v e Cc a n o m
pove^anu			p o v e Cc a n u
pove~anu			p o v e C a n u
povi{enog			p o v i S e n o g
povi{enoga			p o v i S e n o g a
povla~i			p o v l a C i
povoljan			p o v o L a n
povoljne			p o v o L n e
povoljni			p o v o L n i
povoljnih			p o v o L n i h
povoljniji			p o v o L n i j i
povoljno			p o v o L n o
povoljnog			p o v o L n o g
povoljnoga			p o v o L n o g a
povremeno			p o v r e m e n o
po~eo			p o C e o
po~etkom			p o C e t k o m
po~etku			p o C e t k u
po~inje			p o C i N e
pred			p r e d
predjela			p r e d j e l a
predjele			p r e d j e l e
predjelima			p r e d j e l i m a
predve~er			p r e d v e C e r
preko			p r e k o
prema			p r e m a
premda			p r e m d a
premjestila			p r e m j e s t i l a
premjestilo			p r e m j e s t i l o
premje{ta			p r e m j e S t a
premje{tanja			p r e m j e S t a N a
premje{tat			p r e m j e S t a t
preosjetljive			p r e o s j e t L i v e
preosjetljivo{^u			p r e o s j e t L i v o S Cc u
preostali			p r e o s t a l i
preostalom			p r e o s t a l o m
preporuci			p r e p o r u c i
preporu~uje			p r e p o r u C u j e
preporu~ujemo			p r e p o r u C u j e m o
prestanak			p r e s t a n a k
prestati			p r e s t a t i
pret`no			p r e t Z n o
prete`ito			p r e t e Z i t o
prete`no			p r e t e Z n o
prethodne			p r e t h o d n e
prethodnih			p r e t h o d n i h
prevladava			p r e v l a d a v a
prevladavala			p r e v l a d a v a l a
prevladavat			p r e v l a d a v a t
prevladavati			p r e v l a d a v a t i
pri			p r i
pribli`ava			p r i b l i Z a v a
pribli`avanja			p r i b l i Z a v a N a
pribli`ila			p r i b l i Z i l a
pribli`no			p r i b l i Z n o
pridonijet			p r i d o n i j e t
prija{njih			p r i j a S N i h
prije			p r i j e
prije^i			p r i j e Cc i
prijeloma			p r i j e l o m a
prijepodne			p r i j e p o d n e
prijepodneva			p r i j e p o d n e v a
prikladna			p r i k l a d n a
prikladnu			p r i k l a d n u
prilika			p r i l i k a
prilike			p r i l i k e
primili			p r i m i l i
primi~e			p r i m i C e
primjerena			p r i m j e r e n a
primjerenu			p r i m j e r e n u
primorja			p r i m o r j a
primorju			p r i m o r j u
priobalju			p r i o b a L u
pripadni			p r i p a d n i
prirodi			p r i r o d i
prirodu			p r i r o d u
pristi`e			p r i s t i Z e
pritjecanja			p r i t j e c a N a
pritje~e			p r i t j e C e
produbljava			p r o d u b L a v a
prognoza			p r o g n o z a
prognoze			p r o g n o z e
prohladno			p r o h l a d n o
prolaza			p r o l a z a
prolazak			p r o l a z a k
prolazan			p r o l a z a n
prolazna			p r o l a z n a
prolazno			p r o l a z n o
proljetne			p r o L e t n e
prometne			p r o m e t n e
promijenjiva			p r o m i j e N i v a
promijenjivo			p r o m i j e N i v o
promijenjivom			p r o m i j e N i v o m
promijenjivu			p r o m i j e N i v u
promijenjljivo			p r o m i j e N L i v o
promjene			p r o m j e n e
promjenjiva			p r o m j e N i v a
promjenjivo			p r o m j e N i v o
promjenjivom			p r o m j e N i v o m
promjenjivu			p r o m j e N i v u
promjenjljiva			p r o m j e N L i v a
promjenjljivo			p r o m j e N L i v o
promjenjljivom			p r o m j e N L i v o m
promjenjljivu			p r o m j e N L i v u
promjenljiva			p r o m j e n L i v a
promjenljivo			p r o m j e n L i v o
promjenljivom			p r o m j e n L i v o m
promjenljivu			p r o m j e n L i v u
promjenom			p r o m j e n o m
prosinca			p r o s i n c a
prostrana			p r o s t r a n a
prostrane			p r o s t r a n e
prostrano			p r o s t r a n o
prostranog			p r o s t r a n o g
proteklih			p r o t e k l i h
pro{irit			p r o S i r i t
pro{iriti			p r o S i r i t i
pru`a			p r u Z a
prvi			p r v i
prvih			p r v i h
prvo			p r v o
prvom			p r v o m
puhat			p u h a t
pulenat			p u l e n a t
r			r
radenci			r a d e n c i
radni			r a d n i
ranijih			r a n i j i h
ranog			r a n o g
raspolo`ena			r a s p o l o Z e n a
raspolo`ene			 r a s p o l o Z e n e 
raspolo`eni			r a s p o l o Z e n i
raspolo`enja			r a s p o l o Z e N a
raspolo`enje			r a s p o l o Z e N e
raspolo`enjem			r a s p o l o Z e N e m
raspolo`enju			r a s p o l o Z e N u
rast			r a s t
raste			r a s t e
rasti			r a s t i
razdoblja			r a z d o b L a
razdoblje			r a z d o b L e
razdobljima			r a z d o b L i m a
razdra`ljivi			r a z d r a Z L i v i
razdra`ljivost			r a z d r a Z L i v o s t
razdra`ljivosti			r a z d r a Z L i v o s t i
razmjerno			r a z m j e r n o
razvedravanje			r a z v e d r a v a N e
razvedravati			r a z v e d r a v a t i
razvedrit			r a z v e d r i t
razvedriti			r a z v e d r i t i
razvoj			r a z v o j
reumati~ara			r e u m a t i C a r a
reumati~ari			r e u m a t i C a r i
reumati~arima			r e u m a t i C a r i m a
reumatskih			r e u m a t s k i h
reumom			r e u m o m
rijeka			r i j e k a
rijeke			r i j e k e
rijetki			r i j e t k i
rijetkih			r i j e t k i h
rije~kome			r i j e C k o m e
rosulja			r o s u L a
rosuljom			r o s u L o m
s			s
sa			s a
samo			s a m o
samo{^anec			s a m o S Cc a n e c
san			s a n
sasvim			s a s v i m
sati			s a t i
satima			s a t i m a
sava			s a v a
se			s e
sedam			s e d a m
sedamdeset			s e d a m d e s e t
sedamdesetiosam			s e d a m d e s e t i o s a m
sedamdeseti~etiri			s e d a m d e s e t i C e t i r i
sedamnaest			s e d a m n a e s t
sedamsto			s e d a m s t o
sedamstoosam			s e d a m s t o o s a m
sedamstopedesetidva			s e d a m s t o p e d e s e t i d v a
sedamstotrideseti~etiri			s e d a m s t o t r i d e s e t i C e t i r i
sedmi			s e d m i
senja			s e N a
sicilijom			s i c i l i j o m
sije~nja			s i j e C N a
sil			s i l
sinopti~arka			s i n o p t i C a r k a
situacija			s i t u a c i j a
sjever			s j e v e r
sjevera			s j e v e r a
sjeverac			s j e v e r a c
sjeverni			s j e v e r n i
sjevernije			s j e v e r n i j e
sjevernim			s j e v e r n i m
sjevernjak			s j e v e r N a k
sjevernog			s j e v e r n o g
sjevernoga			s j e v e r n o g a
sjevernoj			s j e v e r n o j
sjevernom			s j e v e r n o m
sjevernome			s j e v e r n o m e
sjeveroistok			s j e v e r o i s t o k
sjeveroistoke			 s j e v e r o i s t o k e 
sjeveroistoku		 s j e v e r o i s t o k u
sjeveroisto~ni			s j e v e r o i s t o C n i
sjeveroisto~nim			s j e v e r o i s t o C n i m
sjeveroisto~njak			s j e v e r o i s t o C N a k
sjeveroisto~nog			s j e v e r o i s t o C n o g
sjeverozapada			s j e v e r o z a p a d a
sjeverozapadne			s j e v e r o z a p a d n e
sjeverozapadni			s j e v e r o z a p a d n i
sjeverozapadnim			s j e v e r o z a p a d n i m
sjeverozapadnjak			s j e v e r o z a p a d N a k
sjeverozapadnjaka			s j e v e r o z a p a d N a k a
sjeverozapadno			s j e v e r o z a p a d n o
sjeverozapadnog			s j e v e r o z a p a d n o g
sjeverozapadnom			s j e v e r o z a p a d n o m
sjeverozapadu			s j e v e r o z a p a d u
sjeveru			s j e v e r u
skrenut			s k r e n u t
skrenuti			s k r e n u t i
skretanje			s k r e t a N e
skretanju			s k r e t a N u
skretati			s k r e t a t i
slab			s l a b
slaba			s l a b a
slabe			s l a b e
slabi			s l a b i
slabija			s l a b i j a
slabije			s l a b i j e
slabijeg			s l a b i j e g
slabiji			s l a b i j i
slabiju			s l a b i j u
slabim			s l a b i m
slabit			s l a b i t
slabiti			s l a b i t i
slabjet			s l a b j e t
slabjeti			s l a b j e t i
slabljenja			s l a b L e N a
slabljenju			s l a b L e N u
slabo			s l a b o
slabom			s l a b o m
slabu			s l a b u
slavoniji			s l a v o n i j i
slavonski			s l a v o n s k i
slijede^eg			s l i j e d e Cc e g
slijede^ega			s l i j e d e Cc e g a
slijede^ih			s l i j e d e Cc i h
sljede^eg			s L e d e Cc e g
sljede^ega			s L e d e Cc e g a
sljede^ih			s L e d e Cc i h
sloj			s l o j
slu`be			s l u Z b e
smanjena			s m a N e n a
smanjene			s m a N e n e
smanjenje			s m a N e N e
smanjiti			s m a N i t i
smanjuje			s m a N u j e
smetnje			s m e t N e
smiriti			s m i r i t i
smirivanje			s m i r i v a N e
smirivanju			s m i r i v a N u
smjera			s m j e r a
smo			s m o
smrzava			s m r z a v a
smrzavati			s m r z a v a t i
sna			s n a
sna`na			s n a Z n a
sni`enog			s n i Z e n o g
snijeg			s n i j e g
snijega			s n i j e g a
snijegom			s n i j e g o m
snje`na			s N e Z n a
snom			s n o m
sparno			s p a r n o
split			s p l i t
sporo			s p o r o
spustila			s p u s t i l a
sras			 s r a s 
sredine			s r e d i n e
sredini			s r e d i n i
sredinom			s r e d i n o m
sredi{njem			s r e d i S N e m
sredi{njim			s r e d i S N i m
sredi{njoj			s r e d i S N o j
sredi{te			s r e d i S t e
sredi{tem			s r e d i S t e m
srednje			s r e d N e
srednjeg			s r e d N e g
srednjega			s r e d N e g a
srednjem			s r e d N e m
srednji			s r e d N i
srednjim			s r e d N i m
srednjoj			s r e d N o j
srednjom			s r e d N o m
sredozemlja			s r e d o z e m L a
sredozemljem			s r e d o z e m L e m
sredozemlju			s r e d o z e m L u
sredozemna			s r e d o z e m n a
sredozemne			s r e d o z e m n e
srijedu			s r i j e d u
srijemu			s r i j e m u
sr~ane			s r C a n e
sr~ani			s r C a n i
sr~anih			s r C a n i h
stabilne			s t a b i l n e
stabilnije			s t a b i l n i j e
stabilno			s t a b i l n o
stalno			s t a l n o
stanja			s t a N a
stanje			s t a N e
stanovnici			s t a n o v n i c i
staru			s t a r u
stjepana			s t j e p a n a
sto			s t o
stodevedesetidva			s t o d e v e d e s e t i d v a
stodvanaest			s t o d v a n a e s t
stoga			s t o g a
stojanovi^			s t o j a n o v i Cc
stojedanaest			s t o j e d a n a e s t
stoosamdesetidva			s t o o s a m d e s e t i d v a
stopedesetiosam			s t o p e d e s e t i o s a m
stosedamnaest			s t o s e d a m n a e s t
stotine			s t o t i n e
stotinu			s t o t i n u
sto~etrdesetidva			s t o C e t r d e s e t i d v a
strelec			s t r e l e c
strujanja			s t r u j a N a
stupanj			s t u p a N
stupnja			s t u p N a
stupnjeva			s t u p N e v a
stvaranje			s t v a r a N e
stvarati			s t v a r a t i
su			s u
subote			s u b o t e
subotu			s u b o t u
suho			s u h o
sumaglica			s u m a g l i c a
sumaglice			s u m a g l i c e
sumaglicom			s u m a g l i c o m
sunca			s u n c a
sunce			s u n c e
sun~ana			s u n C a n a
sun~anih			s u n C a n i h
sun~anije			s u n C a n i j e
sun~anim			s u n C a n i m
sun~ano			s u n C a n o
sun~anog			s u n C a n o g
susnje`ica			s u s N e Z i c a
susnje`icom			s u s N e Z i c o m
susnje`icu			s u s N e Z i c u
sustav			s u s t a v
sustava			s u s t a v a
sustavom			s u s t a v o m
sutra			s u t r a
sve			s v e
svetog			s v e t o g
svetoga			s v e t o g a
svi			s v i
svje`e			s v j e Z e
svje`ija			s v j e Z i j a
svje`ije			s v j e Z i j e
t			 t 
t			t
tako			t a k o
tako}er			t a k o dz e r
tamo			t a m o
te			t e
tegoba			t e g o b a
tegobe			t e g o b e
tek			t e k
temperatura			t e m p e r a t u r a
temperaturama			t e m p e r a t u r a m a
temperature			t e m p e r a t u r e
temperaturom			t e m p e r a t u r o m
temperaturu			t e m p e r a t u r u
terezino			t e r e z i n o
tiho			t i h o
tijekom			t i j e k o m
tim			t i m
time			t i m e
tirenskim			t i r e n s k i m
tirenskog			t i r e n s k o g
tirenskom			t i r e n s k o m
tirenskome			t i r e n s k o m e
tisu^e			t i s u Cc e
ti~e			t i C e
tjedna			t j e d n a
tlak			t l a k
tlaka			t l a k a
tlom			t l o m
tlu			t l u
tmurna			t m u r n a
tmurno			t m u r n o
to			t o
toga			t o g a
tokova			t o k o v a
tom			t o m
toplije			t o p l i j e
toplijeg			t o p l i j e g
toplo			t o p l o
toplom			t o p l o m
tramontana			t r a m o n t a n a
tramontane			t r a m o n t a n e
trava			t r a v a
trave			t r a v e
travnjaka			t r a v N a k a
tre^e			t r e Cc e
treba			t r e b a
trebaju			t r e b a j u
trebala			t r e b a l a
trebale			t r e b a l e
trebali			t r e b a l i
trebalo			t r e b a l o
tri			t r i
trideset			t r i d e s e t
tridesetijedan			t r i d e s e t i j e d a n
tridesetipet			t r i d e s e t i p e t
tridesetitri			t r i d e s e t i t r i
trideseti{est			t r i d e s e t i S e s t
trinaest			t r i n a e s t
tristo			t r i s t o
tristojedanaeset			t r i s t o j e d a n a e s e t
tristoosamdesetijedan			t r i s t o o s a m d e s e t i j e d a n
tristotridesetidevet			t r i s t o t r i d e s e t i d e v e t
tu			t u
tunisa			t u n i s a
tunisom			t u n i s o m
tuti{			t u t i S
u			u
udare			u d a r e
udari			u d a r i
udarima			u d a r i m a
uglavno			u g l a v n o
uglavnom			u g l a v n o m
ugodno			u g o d n o
ujutro			u j u t r o
umjerana			u m j e r a n a
umjeren			u m j e r e n
umjerena			u m j e r e n a
umjerene			u m j e r e n e
umjereni			u m j e r e n i
umjereno			u m j e r e n o
umjerenom			u m j e r e n o m
umjerenu			u m j e r e n u
una			u n a
unutra{njost			u n u t r a S N o s t
unutra{njosti			u n u t r a S N o s t i
uobi~ajeno			u o b i C a j e n o
upozorava			u p o z o r a v a
upozoravaju			u p o z o r a v a j u
upozoravamo			u p o z o r a v a m o
upozorenje			u p o z o r e N e
upozorenjem			u p o z o r e N e m
upozoriti			u p o z o r i t i
usporeno			u s p o r e n o
ustalilo			u s t a l i l o
ustalio			u s t a l i o
uticati			u t i c a t i
uti~e			u t i C e
utjecaj			u t j e c a j
utjecaja			u t j e c a j a
utjecajem			u t j e c a j e m
utjecati			u t j e c a t i
utorak			u t o r a k
utorka			u t o r k a
uvijek			u v i j e k
uvjeta			u v j e t a
uvjete			u v j e t e
uvjeti			u v j e t i
uz			u z
uzburkano			u z b u r k a n o
uzdah			u z d a h
uzrokovane			u z r o k o v a n e
uzrokovanih			u z r o k o v a n i h
uzrokovat			u z r o k o v a t
uzrokovati			u z r o k o v a t i
uzrokuje			u z r o k u j e
u~inak			u C i n a k
v			v
vakula			v a k u l a
valoviti			v a l o v i t i
valovito			v a l o v i t o
ve^			v e Cc
ve^a			v e Cc a
ve^e			v e Cc e
ve^eg			v e Cc e g
ve^em			v e Cc e m
ve^i			v e Cc i
ve^ih			v e Cc i h
ve^ina			v e Cc i n a
ve^ini			v e Cc i n i
ve^inom			v e Cc i n o m
vedrije			v e d r i j e
vedro			v e d r o
velebita			v e l e b i t a
velebitskom			v e l e b i t s k o m
velebitskome			v e l e b i t s k o m e
veoma			v e o m a
ve~er			v e C e r
ve~eras			v e C e r a s
ve~ernjim			v e C e r N i m
vidljivost			v i d L i v o s t
vijest			v i j e s t
vikend			v i k e n d
vikenda			v i k e n d a
visini			v i s i n i
visoka			v i s o k a
visokih			v i s o k i h
visokom			v i s o k o m
vi{a			v i S a
vi{e			v i S e
vi{em			v i S e m
vjerojatno			v j e r o j a t n o
vjerojatnost			v j e r o j a t n o s t
vjetar			v j e t a r
vjetra			v j e t r a
vjetrom			v j e t r o m
vjetrovito			v j e t r o v i t o
vla`ni			v l a Z n i
vlasta			v l a s t a
vodostaj			v o d o s t a j
vodostaju			v o d o s t a j u
vratima			v r a t i m a
vrbe			v r b e
vremena			v r e m e n a
vremenom			v r e m e n o m
vremenska			v r e m e n s k a
vremenske			v r e m e n s k e
vremenski			v r e m e n s k i
vremensko			v r e m e n s k o
vremenskog			v r e m e n s k o g
vremenu			v r e m e n u
vrhu			v r h u
vrijeme			v r i j e m e
vrlo			v r l o
vru^e			v r u Cc e
vr{nak			v r S n a k
vukovar			v u k o v a r
z			z
za			z a
zabjelili			z a b j e l i l i
zadr`at			z a d r Z a t
zadr`ati			z a d r Z a t i
zadr`ava			z a d r Z a v a
zadr`e			z a d r Z e
zadru			z a d r u
zagorju			z a g o r j u
zagreb			z a g r e b
zagrebu			z a g r e b u
zahladnjenje			z a h l a d N e N e
zahla}enje			z a h l a dz e N e
zahvatiti			z a h v a t i t i
zale}u			z a l e dz u
zamijeniti			z a m i j e n i t i
zapada			z a p a d a
zapadne			z a p a d n e
zapadni			z a p a d n i
zapadnim			z a p a d n i m
zapadnjak			z a p a d N a k
zapadnoeuropske			z a p a d n o e u r o p s k e
zapadnog			z a p a d n o g
zapadnoj			z a p a d n o j
zapadnom			z a p a d n o m
zapadnu			z a p a d n u
zapadu			z a p a d u
zapuhat			z a p u h a t
zapuhati			z a p u h a t i
zasad			z a s a d
zastoja			z a s t o j a
zatim			z a t i m
zato			z a t o
zatopljenje			z a t o p L e N e
zavoda			z a v o d a
za{tita			z a S t i t a
za{tititi			z a S t i t i t i
za{titu			z a S t i t u
zbog			z b o g
zdravstvo			z d r a v s t v o
zemlje			z e m L e
zemlji			z e m L i
zemlju			z e m L u
znatnije			z n a t n i j e
znatno			z n a t n o
zna~ajnije			z n a C a j n i j e
zna~i			z n a C i
zoran			z o r a n
zrak			z r a k
zraka			z r a k a
zraku			z r a k u
{amac			S a m a c
{esnaest			S e s n a e s t
{est			S e s t
{esto			S e s t o
{estodvadesetiosam			S e s t o d v a d e s e t i o s a m
{esto{ezdeseti~etiri			S e s t o S e z d e s e t i C e t i r i
{esto~etrdesetisedam			S e s t o C e t r d e s e t i s e d a m
{etnju			S e t N u
{ezdeset			S e z d e s e t
{ezdeseti{est			S e z d e s e t i S e s t
{ire			S i r e
{iri			S i r i
{kifi^			S k i f i Cc
{to			S t o
{tovi{e			S t o v i S e
~apka			C a p k a
~emu			C e m u
~esto			C e s t o
~etiri			C e t i r i
~etiristo			C e t i r i s t o
~etiristodevedesetiosam			C e t i r i s t o d e v e d e s e t i o s a m
~etiristopedesetipet			C e t i r i s t o p e d e s e t i p e t
~etrdeset			C e t r d e s e t
~etrdesetijedan			C e t r d e s e t i j e d a n
~etrdesetipet			C e t r d e s e t i p e t
~etrdesetitri			C e t r d e s e t i t r i
~etriri			C e t r i r i
~etristodvedesetidva			C e t r i s t o d v e d e s e t i d v a
~etrnaest			C e t r n a e s t
~etvrtak			C e t v r t a k
~e{^e			C e S Cc e
~e{^i			C e S Cc i
~itavom			C i t a v o m
~vora			C v o r a
~vorova			C v o r o v a 
